人力資源發展系	人力資源發展研究所
人力資源發展研究所	人力資源發展研究所
人力資源暨公共關係學系	人力資源發展研究所
人力資源暨公共關係學系碩士在職專班	人力資源發展研究所
人力資源管理研究所	人力資源發展研究所
人力資源管理研究所碩士在職專班	人力資源發展研究所
人力與知識管理研究所	人力資源發展研究所
科技應用與人力資源發展學系	人力資源發展研究所
科技應用與人力資源發展學系人力資源碩士在職進修專班	人力資源發展研究所
國際人力教育與發展研究所	人力資源發展研究所
終身學習與人力資源發展碩士學位學程碩士在職專班	人力資源發展研究所
	
工業科技教育研究所	工業科技教育研究所
工業科技教育學系	工業科技教育研究所
工業教育研究所	工業科技教育研究所
工業教育與技術學系	工業科技教育研究所
工業教育學系	工業科技教育研究所
工業教育學系在職進修專班	工業科技教育研究所
工業教育學系在職進修碩士班	工業科技教育研究所
	
數理教育研究所	數理教育研究所
數學教育學系在職進修教學碩士學位班	數理教育研究所
數學教育學系教學碩士班	數理教育研究所
數學資訊教育學系數學資訊教育教學碩士學位	數理教育研究所
數學資訊教育學系數學資訊教育教學碩士學位班	數理教育研究所
數學暨資訊教育學系(含數學教育碩士班)	數理教育研究所
	
幼兒保育系所	幼兒保育研究所
幼兒保育系碩士班	幼兒保育研究所
幼兒保育學系	幼兒保育研究所
幼兒教育所	幼兒保育研究所
幼兒教育學系	幼兒保育研究所
幼兒教育學系研究所	幼兒保育研究所
幼兒教育學系碩士在職專班	幼兒保育研究所
幼兒教育學系碩士班	幼兒保育研究所
幼兒與家庭教育學系碩士班	幼兒保育研究所
嬰幼兒保育研究所	幼兒保育研究所
	
自然科學系教學碩士班	自然科學系教學研究所
自然科學教育研究所	自然科學系教學研究所
自然科學教育學系	自然科學系教學研究所
自然科學教育學系碩士班	自然科學系教學研究所
	
特殊教育系所	特殊教育研究所
特殊教育研究所	特殊教育研究所
特殊教育與輔助科技研究所	特殊教育研究所
特殊教育學系	特殊教育研究所
特殊教育學系在職進修碩士班	特殊教育研究所
特殊教育學系所	特殊教育研究所
特殊教育學系研究所	特殊教育研究所
特殊教育學系教學碩士班	特殊教育研究所
特殊教育學系碩士在職專班	特殊教育研究所
特殊教育學系碩士班	特殊教育研究所
特殊教育學系碩士班創造思考組(日)	特殊教育研究所
特殊教育學系碩士班資賦優異組(日)	特殊教育研究所
特殊教育學系碩士班資優組	特殊教育研究所
創造思考暨資賦優異教育研究所	特殊教育研究所
資賦優異研究所	特殊教育研究所
	
人資處美勞教學碩士班	美勞教育研究所
美勞教育研究所	美勞教育研究所
美勞教育學系碩士班	美勞教育研究所
美勞教學碩士班	美勞教育研究所
人資處音樂教學碩士班	美勞教育研究所
藝術教育研究所	美勞教育研究所
藝術與人文教育研究所	美勞教育研究所
藝術與人文教育研究所碩士班	美勞教育研究所
藝術與人文教學研究所	美勞教育研究所
	
人資處教育行政碩士專班	教育行政研究所
教育行政研究所	教育行政研究所
教育行政碩士在職進修專班	教育行政研究所
	
人資處課程與教學碩士班	教育研究所
教育事業創新經營碩士學位在職進修專班	教育研究所
教育研究所	教育研究所
教育研究所碩士在職專班	教育研究所
教育研究所碩士班	教育研究所
教育科技研究所	教育研究所
教育科技學系	教育研究所
教育科技學系碩士在職專班	教育研究所
教育科技學系碩士班	教育研究所
教育科技學系數位學習在職專班	教育研究所
教育專業發展研究所	教育研究所
教育測驗統計研究所	教育研究所
教育傳播與科技研究所	教育研究所
教育經營與管理研究所碩士班	教育研究所
教育經營與管理學系	教育研究所
教育學系	教育研究所
教育學系(所)	教育研究所
教育學系生命教育碩士班	教育研究所
教育學系在職進修碩士班	教育研究所
教育學系研究所	教育研究所
教育學系科技發展與傳播碩士班	教育研究所
教育學系教育行政碩士在職專班	教育研究所
教育學系教育創新與評鑑碩士班	教育研究所
教育學系教育創新與評鑑碩士班在職專班	教育研究所
教育學系教育經營與管理碩博士班	教育研究所
教育學系測驗統計碩博士班	教育研究所
教育學系碩士班	教育研究所
教育學系課程與教學碩士班	教育研究所
教育學系課程與教學碩博士班	教育研究所
教育學系課程與教學澎湖碩士班	教育研究所
教育學系學校經營與管理教學碩士班	教育研究所
教育學研究所	教育研究所
教育學類	教育研究所
教師在職進修自然碩士學位班	教育研究所
教師專業碩士學位學程	教育研究所
教管所課程與教學澎湖碩士班	教育研究所
教學專業發展數位學習碩士在職專班	教育研究所
教學藝術研究所	教育研究所
進修部輔導教學碩士班	教育研究所
課程教學與科技研究所	教育研究所
課程設計與潛能開發學系	教育研究所
課程與教學研究所	教育研究所
課程與教學研究所課程與教學碩士學位在職進	教育研究所
課程與教學研究所課程與教學碩士學位班	教育研究所
學習與教學研究所	教育研究所
學習與媒材設計學系課程與教學碩士班	教育研究所
	
人資處語文教學碩士班	語文教學研究所
國文教學碩士班	語文教學研究所
語文教育學系碩士班	語文教學研究所
語文教育學系碩博士班	語文教學研究所
	
理學院科技與數位學習學程	數位學習科技研究所
理學院碩士在職專班網路學習學程	數位學習科技研究所
理學院網路學習碩士在職專班	數位學習科技研究所
網路學習科技研究所	數位學習科技研究所
數位學習科技系數位學習科技碩士在職專班	數位學習科技研究所
數位學習科技研究所	數位學習科技研究所
數位學習科技學系碩士班	數位學習科技研究所
數位學習科技學系碩博士班	數位學習科技研究所
數位學習教學碩士學位學程	數位學習科技研究所
數位學習設計與管理學系研究所	數位學習科技研究所
數位學習與教育研究所	數位學習科技研究所
	
	
初等教育學系	國民教育研究所
國小科學教育研究所	國民教育研究所
國民教育研究所	國民教育研究所
國民教育研究所教育行政碩士班	國民教育研究所
國民教育學系碩士班	國民教育研究所
	
人資處應用科學系教學碩士班	科學教育研究所
科學教育研究所	科學教育研究所
科學教育碩士學位學程	科學教育研究所
科學教育學系	科學教育研究所
科學應用與推廣學系科學教育碩士班	科學教育研究所
科學應用與推廣學系環境教育及管理碩士班	科學教育研究所
	
音樂系音樂教學碩士班	音樂教育研究所
音樂學系音樂科教學碩士班	音樂教育研究所
音樂學系教學碩士學位班	音樂教育研究所
	
成人及繼續教育所	社會教育學研究所
成人及繼續教育研究所	社會教育學研究所
成人與繼續教育研究所	社會教育學研究所
社會科教育學系碩士班	社會教育學研究所
社會教育學系	社會教育學研究所
社會教育學系在職進修碩士班	社會教育學研究所
高齡者教育所	社會教育學研究所
公民教育與活動領導學系在職進修碩士班	社會教育學研究所
	
技術及職業教育研究所	技職教育研究所
技術及職業教育研究所碩士班	技職教育研究所
技職教育研究所	技職教育研究所
技職教育與人力資源發展研究所	技職教育研究所
	
商業教育學系	商業教育研究所
商業教育學系在職進修專班	商業教育研究所
	
運動教育研究所	運動教育研究所
運動與休閒教育所	運動教育研究所
體育學系教學碩士班	運動教育研究所
體育教育學系	運動教育研究所
	
醫護教育研究所	醫護教育研究所
	
家政教育研究所	家政教育研究所
	
資訊教育研究所	資訊教育研究所
	
環境教育研究所	環境教育研究所
	
心理研究所	心理研究所
心理碩士班	心理研究所
心理與諮商教學碩士學位班	心理研究所
心理學系	心理研究所
心理學所	心理研究所
心理學研究所	心理研究所
社會心理學研究所(含碩專班)	心理研究所
教育心理與輔導研究所	心理研究所
教育心理與輔導學系	心理研究所
教育心理與輔導學系在職進修碩士班	心理研究所
教育心理與輔導學系碩士班	心理研究所
教育心理與諮商研究所	心理研究所
輔導研究所	心理研究所
輔導與諮商學系所	心理研究所
諮商與臨床心理學系	心理研究所
臨床心理學系碩士班	心理研究所
	
人類發展與家庭研究所	家庭研究所
人類發展與家庭學系	家庭研究所
人類發展與家庭學系在職進修碩士班	家庭研究所
家政學研究所	家庭研究所
	
家庭研究與兒童發展研究所	家庭研究與兒童發展研究所
家庭研究與兒童發展學系碩士班	家庭研究與兒童發展研究所
	
兒童文學研究所	兒童福利研究所
兒童福利研究所	兒童福利研究所
兒童福利學系	兒童福利研究所
兒童與家庭服務系	兒童福利研究所
兒童與家庭學系碩士在職專班	兒童福利研究所
青少年兒童福利研究所	兒童福利研究所
	
土木工程系所	土木工程研究所
土木工程學系	土木工程研究所
土木與防災技術研究所	土木工程研究所
	
工程科學系	工程研究所
工業與系統工程研究所	工程研究所
生物工程學系(所)	工程研究所
	
工學院工程管理專班	工業工程與管理研究所
工業工程與管理系	工業工程與管理研究所
工業工程與管理系碩士班	工業工程與管理研究所
工業工程與管理研究所	工業工程與管理研究所
工業工程與管理學系	工業工程與管理研究所
工業工程與管理學系碩士班	工業工程與管理研究所
工業管理研究所	工業工程與管理研究所
工業管理學系	工業工程與管理研究所
工業管理學系碩士班	工業工程與管理研究所
工業與資訊管理學系專班	工業工程與管理研究所
	
工業設計系碩士班	工業設計研究所
工業設計研究所	工業設計研究所
工業設計學系	工業設計研究所
工業設計學系(所)	工業設計研究所
工業設計學系碩士班	工業設計研究所
工業設計學系碩博士班	工業設計研究所
	
化學系	化學研究所
化學系在職進修碩士班	化學研究所
化學研究所	化學研究所
化學學系	化學研究所
	
物理研究所	物理研究所
物理學系	物理研究所
應用物理暨化學系	物理研究所
應用物理暨化學系自然科學教學碩士學位班	物理研究所
	
室內設計研究所	室內設計研究所
室內設計學系	室內設計研究所
	
建築研究所	建築研究所
建築與環境設計研究所	建築研究所
產品與建築設計研究所碩士在職專班	建築研究所
	
科技藝術研究所	美術研究所
美術研究所	美術研究所
美術產業碩士學位在職進修專班	美術研究所
美術學系	美術研究所
美術學系在職進修碩士班	美術研究所
美術學系碩士班	美術研究所
美學與藝術管理研究所	
應用藝術所	美術研究所
應用藝術研究所	美術研究所
藝術與造形設計學系碩士班	美術研究所
藝術學系碩士班	美術研究所
	
工藝設計學系	設計研究所
商業設計研究所	設計研究所
設計研究所	設計研究所
設計暨藝術學院碩士在職專班	設計研究所
設計暨藝術學院碩士班	設計研究所
設計管理研究所碩士班	設計研究所
設計學院暨創意生活應用設計研究所	設計研究所
設計學院碩士班	設計研究所
創意生活設計系	設計研究所
創新設計研究所	設計研究所
創新設計與創業管理研究所	設計研究所
應用設計研究所	設計研究所
	
多媒體動畫藝術學系	多媒體設計研究所
多媒體設計研究所	多媒體設計研究所
數位內容科技學系碩士班	多媒體設計研究所
數位內容與動畫設計研究所	多媒體設計研究所
數位科技設計學系(含玩具與遊戲設計碩士班)	多媒體設計研究所
數位媒體設計學系碩士班	多媒體設計研究所
	
視覺設計學系	視覺傳達設計研究所
視覺傳達設計系數位文創設計碩士在職專班	視覺傳達設計研究所
視覺傳達設計研究所	視覺傳達設計研究所
視覺傳達設計學系碩士班	視覺傳達設計研究所
視覺藝術研究所	視覺傳達設計研究所
視覺藝術教育研究所	視覺傳達設計研究所
視覺藝術教育學系	視覺傳達設計研究所
視覺藝術教育學系碩士班	視覺傳達設計研究所
視覺藝術學系碩士班	視覺傳達設計研究所
	
傳播管理研究所碩士在職專班	傳播研究所
傳播管理研究所碩士班	傳播研究所
新聞學研究所	傳播研究所
資訊傳播研究所	傳播研究所
資訊傳播學系	傳播研究所
資訊傳播學研究所(含碩專班)	傳播研究所
圖文傳播暨數位出版學研究所(含碩專班)	傳播研究所
圖文傳播藝術學系碩士班	傳播研究所
圖書資訊學數位碩士在職專班	傳播研究所
	
創造力發展碩士在職專班	創造力發展研究所
創造力發展碩士班	創造力發展研究所
創造思考暨資賦優異教育研究所	創造力發展研究所
	
生活應用科學系碩士在職專班	應用科學研究所
生活應用科學研究所	應用科學研究所
應用科學系碩士班	應用科學研究所
	
產業創新與經營學系碩士班	企業管理研究所
中小企業經營策略管理研究所	企業管理研究所
文教事業經營研究所	企業管理研究所
生物事業管理學系研究所	企業管理研究所
企業創新發展研究所	企業管理研究所
企業創新與創業管理研究所	企業管理研究所
企業管理系	企業管理研究所
企業管理系事業經營碩士班	企業管理研究所
企業管理系碩士在職專班	企業管理研究所
企業管理系碩士班	企業管理研究所
企業管理系管理科學碩博士班	企業管理研究所
企業管理所	企業管理研究所
企業管理研究所	企業管理研究所
企業管理研究所(含碩專班)	企業管理研究所
企業管理學系	企業管理研究所
企業管理學系在職專班	企業管理研究所
企業管理學系所	企業管理研究所
企業管理學系研究所	企業管理研究所
企業管理學系國際企業經營管理	企業管理研究所
企業管理學系專班	企業管理研究所
企業管理學系碩士在職專班	企業管理研究所
企業管理學系碩士班	企業管理研究所
企業管理學系碩博士班	企業管理研究所
企業管理學系管理學碩士在職專班	企業管理研究所
企業管理學系管理學碩士班	企業管理研究所
企業與創業管理學系	企業管理研究所
全球華商經營管理數位學習碩士在職專班	企業管理研究所
行銷與流通管理所	企業管理研究所
事業經營研究所	企業管理研究所
事業經營學系(所)	企業管理研究所
亞太工商管理學系碩士班	企業管理研究所
工商管理學系	企業管理研究所
非營利事業管理學系	企業管理研究所
高階經理人碩士在職專班	企業管理研究所
高階管理碩士在職專班	企業管理研究所
高階管理碩士在職專班(EMBA)	企業管理研究所
商務經營研究所	企業管理研究所
商業自動化與管理研究所	企業管理研究所
商學研究所	企業管理研究所
經濟管理研究所	企業管理研究所
經營管理研究所	企業管理研究所
經營管理碩士班(領導學程)	企業管理研究所
經營管理碩士學程(EMBA)	企業管理研究所
資源管理及決策研究所	企業管理研究所
資源管理研究所	企業管理研究所
管院碩士在職專班	企業管理研究所
管理研究所	企業管理研究所
管理科學系所	企業管理研究所
管理科學研究所	企業管理研究所
管理科學研究所碩士班	企業管理研究所
管理碩士在職專班	企業管理研究所
管理碩士學位學程	企業管理研究所
管理學研究所	企業管理研究所
管理學院經營管理學程	企業管理研究所
管理學院碩士在職專班	企業管理研究所
管理學院碩士在職專班管理科學組	
管理學院管理碩士在職專班	企業管理研究所
領導研究所	企業管理研究所
	
科技管理所	科技管理研究所
科技管理研究所	科技管理研究所
科技管理學系碩士在職專班	科技管理研究所
科技管理學系碩士班	科技管理研究所
	
休閒事業管理學系碩士班	餐旅與休閒管理研究所
休閒遊憩研究所	餐旅與休閒管理研究所
休閒遊憩管理學系碩士在職專班	餐旅與休閒管理研究所
休閒管理研究所	餐旅與休閒管理研究所
休閒與遊憩管理學系碩士在職專班	餐旅與休閒管理研究所
身心整合與運動休閒產業學系	餐旅與休閒管理研究所
健康產業管理研究所	餐旅與休閒管理研究所
餐旅教育研究所在職專班	餐旅與休閒管理研究所
餐旅管理教學碩士學位班	餐旅與休閒管理研究所
餐旅管理學系碩士班	餐旅與休閒管理研究所
觀光休閒事業管理研究所	餐旅與休閒管理研究所
觀光休閒管理研究所	餐旅與休閒管理研究所
觀光事業研究所	餐旅與休閒管理研究所
觀光事業學系	餐旅與休閒管理研究所
觀光事業學系研究所	餐旅與休閒管理研究所
觀光與餐旅管理系	餐旅與休閒管理研究所
觀光與餐旅管理研究所	餐旅與休閒管理研究所
觀光學研究所(含碩專班)	餐旅與休閒管理研究所
	
國際企業所	國際企業研究所
國際企業研究所碩博士班	國際企業研究所
國際企業經營系碩士班	國際企業研究所
國際企業管理研究所	國際企業研究所
國際企業管理學系	國際企業研究所
國際企業管理學系碩士在職專班	國際企業研究所
國際企業管理學系碩士班	國際企業研究所
國際企業學系	國際企業研究所
國際企業學系研究所	國際企業研究所
國際企業學系碩士在職專班	國際企業研究所
國際經營管理研究所碩士在職專班	國際企業研究所
國際經營與貿易研究所	國際企業研究所
	
資訊經營學系(所)	資訊管理研究所
資訊管理技研究所	資訊管理研究所
資訊管理系	資訊管理研究所
資訊管理系碩士班	資訊管理研究所
資訊管理研究所	資訊管理研究所
資訊管理學系	資訊管理研究所
資訊管理學系所	資訊管理研究所
資訊管理學系研究所	資訊管理研究所
資訊管理學系碩士在職專班	資訊管理研究所
資訊管理學系碩士班	資訊管理研究所
	
醫務管理碩士學位學程	醫務管理研究所
醫務管理學系(所)	醫務管理研究所
醫務管理學系碩士班	醫務管理研究所
	
中國文學系	中國文學研究所
中國語文學系碩士班	中國文學研究所
國文所-中國文學教學碩士班	中國文學研究所
國文學系	中國文學研究所
國文學系在職進修碩士班	中國文學研究所
語文與創作學系碩士班	中國文學研究所
	
資訊工程研究所	資訊工程研究所
資訊工程學系	資訊工程研究所
資訊工程學系碩士班	資訊工程研究所
資訊科學系	資訊工程研究所
資訊科學系碩士在職專班	資訊工程研究所
資訊科學與工程研究所	資訊工程研究所
資訊科學學系	資訊工程研究所
電機資訊學院碩士在職專班	資訊工程研究所
	
公共行政研究所	公共行政研究所
公共政策研究所	公共行政研究所
行政管理碩士學程	公共行政研究所
勞工研究所	公共行政研究所
勞工關係學系暨研究所	公共行政研究所
學校行政碩士在職專班	公共行政研究所
	
數學系	數學研究所
數學系所	數學研究所
數學研究所	數學研究所
應用數學系	數學研究所
應用數學所	數學研究所
	
舞蹈研究所	舞蹈研究所
舞蹈碩士班	舞蹈研究所
舞蹈學系	舞蹈研究所
體育舞蹈學系碩士班	舞蹈研究所
	
生命科學研究所	科學研究所
地球科學研究所	科學研究所
自然科學系碩士班	科學研究所
	
園藝暨景觀學系	園藝暨景觀研究所
園藝學系碩士班	園藝暨景觀研究所
	
音樂學系碩士在職專班	音樂研究所
音樂學系碩士班	音樂研究所
音樂學系	音樂研究所
	
光電科學研究所	光電科學研究所
光電科學與工程學系	光電科學研究所
	
外國文學所	外國文學研究所
英文學系碩士班	外國文學研究所
英國語文學研究所	外國文學研究所
	
運動科學研究所	體育研究所
運動健康管理學系	體育研究所
體育研究所	體育研究所
體育推廣學系碩士班	體育研究所
體育與健康休閒研究所	體育研究所
體育與健康休閒學系研究所	體育研究所
體育與運動科學系	體育研究所
體育學系	體育研究所
體育學系碩士在職專班	體育研究所
	
劇場藝術學系研究所	戲劇研究所
戲劇研究所	戲劇研究所
戲劇創作與應用學系碩士班	戲劇研究所
戲劇學系	戲劇研究所
	
護理研究所	護理研究所
護理學研究所	護理研究所
	
外國語文學系	外國語文學研究所
英語學系	外國語文學研究所
應用英語系	外國語文學研究所
應用英語學系碩士班	外國語文學研究所
	
測驗統計研究所	統計研究所
應用統計資訊學系碩士班	統計研究所
	
文化創意產業系	創意產業研究所
藝術創意產業學系	創意產業研究所
	
歷史學系	歷史研究所
歷史與地理學系社會科教學碩士學位班	歷史研究所
	
日本研究所	日本研究所
	
金融與風險管理所	金融與風險管理所
	
哲學研究所	哲學研究所
	
會計研究所	會計研究所
	
航運管理學系	航運管理研究所
	
機械與電腦輔助工程學系	機械與電腦輔助工程研究所
	
織品服裝學系	織品服裝研究所
