absorptive capacity	absorptive capacity
adoption	adoption
agricultural	agricultural
alliance	allicances
alliances	allicances
asia	asia
automotive	automotive
biotechnology	biotechnology
business models	business models
business model	business models
china	china
chinese	china
cluster	clusters
clusters	clusters
collaboration	collaboration
collaborative	collaboration
communities	communities
community	communities
countries	countries
country	countries
creative	creativity
creativity	creativity
cultural	cultural
culture	cultural
consumer	customers/consumers/users
consumers	customers/consumers/users
customer	customers/consumers/users
customers	customers/consumers/users
user	customers/consumers/users
users	customers/consumers/users
determinant	determinants/factors
determinants	determinants/factors
factor	determinants/factors
factors	determinants/factors
diffusion	diffusion
disruptive	disruptive
diversity	diversity
driver	drivers
drivers	drivers
dynamic	dynamics
dynamics	dynamics
eco-innovation	eco-innovation
economic	economic
economy	economic
economies	economies
effect	effects
effects	effects
efficiency	efficiencies
efficiencies	efficiencies
energy	energy
entrepreneurer	entrepreneurship
entrepreneurers	entrepreneurship
entrepreneurial	entrepreneurship
entrepreneurship	entrepreneurship
environment	environmental
environmental	environmental
eu	europe
europe	europe
european	europe
evolution	evolution
financial	financial
company	firms
companies	firms
corporate	firms
corporates	firms
enterprise	firms
enterprises	firms
firm	firms
firm s	firms
firm-level	firms
firms	firms
geography	geography
german	german
germany	german
government	government
green	green
high-tech	high-tech
hrm	human resources
human resources	human resources
human resource	human resources
ict	ict
information technology	ict
impact	impacts
impacts	impacts
incremental	incremental
india	india
indian	india
industrial	industry
industries	industry
industry	industry
innovation system	innovation systems
innovation systems	innovation systems
institutional	institutions
institutions	institutions
intellectual property	intellectual property
internationalization	international
multinational	international
italy	italy
italian	italy
japan	japan
japanese	japan
knowledge	knowledge
korea	korea
korean	korea
management	management
managerial	management
managing	management
manufacturing	manufacturing
marketing	marketing
market	markets
markets	markets
medical	medical
network	networks
networks	networks
open innovation	open innovation
organisational	organizations
organization	organizations
organizational	organizations
organizations	organizations
outsourcing	oursourcing
pharmaceutical	pahrmaceutical
patent	patents
patents	patents
performance	performance
policies	policies
policy	policies
process	processes
processes	processes
production	production
productivity	productivity
product	products
products	products
region	regional
regions	regional
regional	regional
regulation	regulation
regulations	regulation
sectors	sectors
sector	sectors
sectoral	sectors
service	services
services	services
sme	smes
smes	smes
social	social
spain	spanish
spanish	spanish
spillover	spillovers
spillovers	spillovers
strategic	strategies
strategies	strategies
strategy	strategies
supply chain	supply chain
sustainability	sustanability
sustainable	sustanability
taiwan	taiwan
taiwanese	taiwan
technological	technologies
technologies	technologies
technology	technologies
uk	uk
united kingdom	uk
universities	universities
university	universities
